{
  "tiles" : [ [1, 1, 1, 1, 1, 1, 1, 1, 1 ],
              [0, 1, 1, 1, 1, 1, 1, 1, 0 ],
              [1, 0, 1, 1, 0, 1, 1, 0, 1 ],
              [1, 1, 0, 1, 0, 1, 0, 1, 1 ],
              [1, 1, 1, 0, 0, 0, 1, 1, 1 ],
              [1, 1, 1, 1, 0, 1, 1, 1, 1 ],
              [1, 1, 1, 0, 1, 0, 1, 1, 1 ],
              [1, 1, 0, 1, 1, 1, 0, 1, 1 ],
              [1, 0, 1, 1, 1, 1, 1, 0, 1 ] ],

  "goal" : 550,
  "moves" : 12,
  "timer" : 55,

}
