{
  "tiles" : [ [1, 1, 1, 1, 1, 1, 1, 1, 1 ],
              [1, 1, 1, 1, 1, 1, 1, 1, 1 ],
              [1, 0, 0, 0, 0, 0, 0, 1, 1 ],
              [1, 0, 1, 1, 1, 1, 0, 1, 1 ],
              [1, 0, 1, 1, 1, 1, 0, 1, 1 ],
              [1, 0, 0, 0, 0, 0, 0, 1, 1 ],
              [1, 0, 1, 1, 1, 1, 1, 1, 1 ],
              [1, 0, 1, 1, 1, 1, 1, 1, 1 ],
              [1, 0, 1, 1, 1, 1, 1, 1, 1 ] ],

  "goal" : 600,
  "moves" : 12,
  "timer" : 50,
}
