{
  "tiles" : [ [1, 1, 0, 1, 1, 1, 1, 1, 1 ],
              [1, 1, 1, 0, 1, 1, 1, 1, 1 ],
              [1, 1, 1, 1, 0, 1, 1, 1, 1 ],
              [1, 1, 1, 1, 1, 0, 1, 1, 1 ],
              [1, 1, 1, 1, 1, 1, 0, 1, 1 ],
              [1, 1, 1, 0, 1, 1, 1, 0, 1 ],
              [1, 1, 0, 1, 0, 1, 1, 1, 0 ],
              [1, 0, 1, 1, 1, 0, 1, 1, 1 ],
              [0, 1, 1, 1, 1, 1, 0, 1, 1 ] ],

  "goal" : 650,
  "moves" : 15,
  "timer" : 50,
}
