{
   "tiles" : [ [0, 0, 0, 1, 0, 0, 0, 1, 1 ],
               [0, 0, 1, 1, 1, 0, 0, 1, 1 ],
               [0, 1, 1, 1, 1, 1, 0, 1, 1 ],
               [1, 1, 1, 1, 1, 1, 1, 0, 0 ],
               [0, 0, 0, 0, 0, 0, 0, 0, 0 ],
               [0, 1, 1, 1, 1, 1, 1, 1, 0 ],
               [0, 0, 1, 1, 1, 1, 1, 0, 0 ],
               [0, 0, 0, 1, 1, 1, 1, 0, 0 ],
               [0, 0, 0, 1, 1, 1, 0, 0, 0 ] ],
    
    "goal" : 600,
    "moves" : 25,
    "timer" : 60,
}
