{
  "tiles" : [ [0, 0, 0, 0, 1, 0, 0, 0, 0 ],
              [0, 0, 0, 1, 1, 1, 0, 0, 0 ],
              [0, 0, 1, 1, 1, 1, 1, 0, 0 ],
              [0, 1, 1, 1, 1, 1, 1, 1, 0 ],
              [0, 1, 1, 1, 1, 1, 1, 1, 0 ],
              [0, 1, 1, 1, 1, 1, 1, 1, 0 ],
              [0, 1, 1, 1, 1, 1, 1, 1, 0 ],
              [0, 0, 0, 1, 1, 1, 0, 0, 0 ],
              [0, 0, 0, 0, 1, 0, 0, 0, 0 ] ],

  "goal" : 650,
  "moves" : 15,
  "timer" : 55,

}
