{
   "tiles" : [ [0, 0, 1, 1, 0, 1, 1, 0, 0 ],
               [1, 1, 1, 1, 0, 1, 1, 1, 1 ],
               [1, 1, 1, 1, 0, 1, 1, 1, 1 ],
               [1, 0, 1, 1, 1, 1, 1, 0, 1 ],
               [1, 0, 1, 1, 1, 1, 1, 0, 1 ],
               [1, 0, 1, 1, 1, 1, 1, 0, 1 ],
               [1, 1, 1, 1, 0, 1, 1, 1, 1 ],
               [1, 1, 1, 1, 0, 1, 1, 1, 1 ],
               [0, 0, 0, 1, 0, 1, 0, 0, 0 ] ],

  "goal" : 500,
  "moves" : 12,
    "timer" : 40,

}
