{
  "tiles" : [ [1, 1, 1, 0, 0, 0, 0, 0, 0 ],
              [1, 1, 1, 0, 1, 1, 1, 1, 0 ],
              [1, 1, 1, 0, 1, 1, 1, 1, 0 ],
              [0, 0, 0, 1, 1, 1, 0, 0, 0 ],
              [0, 0, 0, 1, 1, 1, 0, 0, 0 ],
              [0, 0, 0, 1, 1, 1, 0, 0, 0 ],
              [0, 1, 1, 1, 1, 0, 1, 1, 1 ],
              [0, 1, 1, 1, 1, 0, 1, 1, 1 ],
              [0, 0, 0, 0, 0, 0, 1, 1, 1 ] ],

  "goal" : 500,
  "moves" : 20,
  "timer" : 50,
}
