{
   "tiles" : [ [1, 1, 1, 1, 1, 1, 1, 1, 1 ],
               [0, 0, 0, 0, 0, 0, 0, 0, 0 ],
               [1, 1, 1, 1, 0, 1, 1, 1, 1 ],
               [1, 1, 1, 1, 0, 1, 1, 1, 1 ],
               [1, 1, 1, 1, 0, 1, 1, 1, 1 ],
               [0, 0, 0, 0, 0, 0, 0, 0, 0 ],
               [1, 1, 1, 1, 0, 1, 1, 1, 1 ],
               [1, 1, 1, 1, 0, 1, 1, 1, 1 ],
               [1, 1, 1, 1, 0, 1, 1, 1, 1 ] ],
    
    "goal" : 600,
    "moves" : 15,
    "timer": 60,
}
