{
  "tiles" : [ [0, 0, 0, 0, 0, 0, 1, 1, 1 ],
              [0, 0, 0, 0, 0, 0, 1, 1, 1 ],
              [0, 0, 0, 0, 0, 0, 1, 1, 1 ],
              [0, 0, 0, 1, 1, 1, 0, 0, 0 ],
              [0, 0, 0, 1, 1, 1, 0, 0, 0 ],
              [0, 0, 0, 1, 1, 1, 0, 0, 0 ],
              [1, 1, 1, 0, 0, 0, 0, 0, 0 ],
              [1, 1, 1, 0, 0, 0, 0, 0, 0 ],
              [1, 1, 1, 0, 0, 0, 0, 0, 0 ] ],

  "goal" : 550,
  "moves" : 20,
  "timer" : 60,

}
