{
   "tiles" : [ [1, 0, 1, 1, 1, 1, 1, 0, 1 ],
               [1, 1, 0, 1, 1, 1, 0, 1, 1 ],
               [1, 1, 1, 0, 1, 0, 1, 1, 1 ],
               [1, 0, 0, 1, 1, 1, 0, 0, 1 ],
               [1, 0, 0, 1, 1, 1, 0, 0, 1 ],
               [1, 1, 1, 1, 0, 1, 1, 1, 1 ],
               [1, 1, 1, 1, 1, 1, 1, 1, 1 ],
               [1, 1, 1, 0, 0, 0, 1, 1, 1 ],
               [1, 1, 1, 0, 0, 0, 1, 1, 1 ] ],
    
    "goal" : 550,
    "moves" : 15,
    "timer": 45,
}
