{
  "tiles" : [ [1, 1, 1, 1, 0, 1, 1, 1, 1 ],
              [1, 1, 1, 0, 1, 0, 1, 1, 1 ],
              [1, 1, 0, 1, 1, 1, 0, 1, 1 ],
              [1, 0, 1, 0, 1, 0, 1, 0, 1 ],
              [1, 0, 1, 1, 0, 1, 1, 0, 1 ],
              [1, 0, 1, 1, 1, 1, 1, 0, 1 ],
              [1, 0, 1, 1, 1, 1, 1, 0, 1 ],
              [1, 0, 1, 0, 1, 0, 1, 0, 1 ],
              [1, 0, 1, 1, 1, 1, 1, 0, 1 ] ],

  "goal" : 450,
  "moves" : 15,
  "timer" : 40,
}
