{
   "tiles" : [ [1, 1, 1, 0, 0, 0, 1, 1, 1 ],
               [1, 1, 1, 0, 0, 0, 1, 1, 1 ],
               [1, 1, 1, 1, 1, 1, 1, 1, 1 ],
               [0, 0, 1, 0, 0, 0, 1, 0, 0 ],
               [0, 0, 1, 0, 0, 0, 1, 0, 0 ],
               [0, 0, 1, 0, 0, 0, 1, 0, 0 ],
               [1, 1, 1, 1, 1, 1, 1, 1, 1 ],
               [1, 1, 1, 0, 0, 0, 1, 1, 1 ],
               [1, 1, 1, 0, 0, 0, 1, 1, 1 ] ],
    
    "goal" : 500,
    "moves" : 15,
    "timer" : 50,
}
